10
1 _ * _ _ _ * _ * _
_ _ * _ * _ * _ * _
* _ _ _ * _ * _ * _
* _ * * * _ * _ _ _
* _ * _ _ _ * _ * _
_ _ * _ * * * _ * _
_ _ * _ * _ * _ _ _
_ _ * _ _ _ _ _ * _
_ _ * _ * _ * _ * _
_ _ * _ * _ * _ _ 2
